G G G G G G G G G G G G G G G G G G G
G R R R R G G G G G G G G G G F G G G
G G G G R G G G G G F F F G G F G G G
G G G G R G G G G G F G F G G F G G G
G G G G R R R R R R R G F G G R G G G 
G G G G G G G G G G G G F G G R G G G
G F F F G G G G G G G G F G G R G G G
G F G F G G G G G G G G G G G R G G G
G F F F G G G G G G G G G G G R G G G
G G G G G G G G G G G G G G G R G G G
G G G G G G G G G G G G G G G R G G G
G G R R R R R R R R R R R R R R R R R
G G R G G G G G G G G G G G G G G G G
G G R G F F F F F F F F F F F F F F F
G G R G F G G G G G G G G G G G G G F 
G G R G F G G G G G G G G G G G G G f 
G G R G F G G G G G G G G G G G G G f 
G G R G F G G G G G G G G G G G G G f 
G G R G F G G G G G G G G G G G G G f 
G G R G F G G G G G G G G G G G G G f
G G R G F F F F F F F F F F F F F F F 
